----------o--------------------------------------------------------------------------------------------------------------oo-----------------------------------------------o-----------------------------
------------------------------------------------------------------o--------------------------------------------o------------o----------------------------o--------------------o-------------------------
----------------------------------------------------------------------------------------------------------------o----o--------------o-o-----------------------------------------------------------------
----------------------------------------------------o----------------------------------o----------------------------------------o---------------------o-------------------------------------------------
-----------------------------------------------------------o----------------------------------------------------------------------------------------------------------------o------o--------------------
------------------------------------------o---------------------------------------------------------------------o---------------------------------------------------------------------------------------
--------------o-------------------------------o---------------------------------------------------------o---o----------------------------------------------------o--------------------------------------
-------------------------------------------------------BMMB--------------?BBM--------------------------------------------------------------------------------------------------------------------------v
-----------------------------------------------BBMBB----------BMBBB---------------------?BBB----------------------------------?BMMB-----------------------BMBB-----------------------------------------f
------------------------------------------------------------------------------------------------------------------------BMMB---------------------------------------------?BBB--------------------------f
--------------------------------BB--MBM----------------------------------------------------------------------------------------------------------------------------------------------------------------f
----------------------------------------------------------------------------------------------------------?BBM----M-------------------------------o----------------------------------------------------f
----------o-------------------------------------------------------------------------o------------------------------------------------------------------------------------------------------------------f
-------E---------------------E----T----o------------------------------T-X----------------T-----o----------------------o--E---------------E-----T----------------------T-----o------------T----XX-------f
mE-----X--X-----o-X-------X-oX----|X--------E-----X------------------E|-XX----X--EXX-XX--|--------------X-----X-E---XE---X--X--X------X--X-----|--E-----------E-------|---------o-X------|-E--XX----E--X
XXXXXXXXXXXXXXXXXXXXXXXXXXXXXXXXXXXXXXXXXXXXXXXXXXXXXXXXXXXX--XXXXXXXXXXXXXXXXXXXXXXXXXXXXXXXXX--XXXXXXXXXXXXXXXXXXXXXXXXXXXXXXXX---XXXXXXXXXXXXXXXXXXX---X---XXXXXXXXXXXXXX---XXXXXXXXXXXXXXXXXX---XXXX
