XXXXXXXXXXXXXXXXX
Xa11111111111111X
X99X9XXX7XXXXXX1X
X9999951133311X1X
X112255555211141X
X1434333244411X1X
X128433XXX1421X1X
X699333XdX9111X1X
X999111XXX9XXXX1X
X9X91111119911X1X
XbX91231132911X1X
X1X94613429961X1X
X1X13233329916X1X
X1X1825555911cX1X
X1XXXXXXXXXXXXX1X
XX1111111111111XX
XXXXXXXXXXXXXXXXX